None
OOOOOOOOOOOOOOOOOO
OOOOOOOOOOOOOOOOOO
OOOOOOOOOOOOOOOOOO
OOOOOOOOEOOOOOOOOO
OOOOOOOOSOOOOOOOOO
AOOOOOOOAAOOMMOOOA
AAAAAAAAAAAAAAAAAA
AAAAAAAAAAAAAAAAAA
AAAAAAAAAAAAAAAAAA