blue_land, blue_grass
OOOOOOOOOOOOOOOOOOOOOOOO'''OOOOOOOOO
OOOOOOOOOOOOOOOOOOOOOOOO'e'OOOOOOOOO
OOOOOOOAAOOOOOOOOOOOOOOO's'OOOOOOOOO
OOOOOOOAAOOOOcOOOOOOOOOAAAAAOOOOOOOP
OOOOOOOAAOOOOAPOOOOOOOOOOOBOOOOOOOOA
OOOOOOOAAOOOOAPOOOOOOOOOOOOOOOOOOOPA
OOOOOOOAAOOOAAPOOOOOMMMOOOOOOOOOOOPA
EOOOOOrAAOOOAAPOQOOOOOOOOOOOOOOOOOPA
SOOOAAAAAAAAAAOKOGOOOOOPPOOOOOOOOOPA
AAAAAAAAAAAAAAAAAAAAAAAAAOOOMMMOOOPA
AAAAAAAAAAAAAAAAAAAAAAAAALLLOOOOOOPA
AAAAAAAAAAAAAAAAAAAAAAAAAL;LOOcOGOOA
AAAAAAAAAAAAAAAAAAAAAAAAAAAAAAAAAAAA