None
EAOOAOOAOAOOOOOOOOAOAAOOOOOAAOOOAOOOOPOAOOOAOAOAOA
SOAOAAOAOOOOOOAOOAAOOOMOOOOOAAOOAOOOOAOAAOAOPOOOQO
AOOAOOOOOAOOOOAAOOAOOOOcOAOOAAOOOAOOOOOOAOOOAALLOO
AAAOOOOAAOAOAOOOAOOOOAOAOOMOAOOOAOAOAOAOAOOAAOAAAO
AAAAAOOOOAAOOAOOOOOOOAOOAAOOAAOOOPOOAOOOAOOAOPAAAA
OAAAAOOOOOOOOOOOOOAAAOAAOOAOOOOOAOOOOOOOOOOOAOOOOO
OOAAOAOOAOOOOOOAOOAOOOOOAAOOOAAOOAAOOOOAAOOOOOOAAA
OOBOAOOOAAAOAAOOAAAOOOOAOAAAPAOOOOOAOOOAOOAAOOAOOO
OcOOAPAOOAOOOOAAAOOAOAPAOAAAOOOOOAOAOPOAOOOAOAOOOO
OAOOOOOOOAOAAAAOOOOAOAOAAOAOOAAOOOAOAAOAOAOOAAOAOO
