colored_desert
OOOOOOOOOOOOOOOOOOOOOOOOO
OOOOOOOOOOOOOOOOOOOOOOOOO
OOOOOOOOOOOOOOOOOOOeOOOOO
OOOOOOOOOOOOOOOOOOOsOOOOO
OOOOOOOOOOOOOOOOOOOOOOOOO
OOOOOOOOOOOOOOOOOOOOOOOOO
OOOOOOOOOOOOOOOOOOOOOOOOO
OOOOOOOOOPPPPPPPPPPPOOOOO
AAAAAAAAAAAAAAAAAAAAPPAAA
AAAAAAAAAAAAAPPPPPPPOOPAA
EOOOOOOOOOOOOOOOOOOOOOPAA
SOOOOOOOOOOOOOOOOOOOOOPAA
AAAAAAAAAAAAAOOOOOOOOAOAA
AAAAAAAAAAAAAPPPPPPPPAAAA
AAAAAAAAAAAAAAAAAAAAAAAAA