None
OOOOOOOOOOOOOOOOOOOOOOOO'''OOOOOOOOOO
OOOOOOOOOOOOOOOOOOOOOOOO'e'OOOOOOOOOO
OOAOOOOAAOOOOOOOOOOOOOOO's'OOOOOOOOOO
OOAAAOOAAOOOOcOOOOOOOOOAAAAAOOOOOOOPO
OOAAAOOAAOOOOAPOOOOOOOOOOOBOOOOOOOOAO
OOOOOOOAAOOOOAPOOOOOOOOOOOOOOOOOOOPAO
OOOOOOOAAOOOAAPOOOOOMMMOOOOOOOOOOOPAO
EOOOOOrAAOOOAAPOQOOOOOOOOOOOOOOOOOPAO
SOOOAAAAAAAAAAOKOGOOOOOPPOOOOOOOOOPAO
AAAAAAAAAAAAAAAAAAAAAAAAAOOOMMMOOOPAO
AAAAAAAAAAAAAAAAAAAAAAAAALLLOOOOOOPAO
AAAAAAAAAAAAAAAAAAAAAAAAAL;LOOcOGOOAO
AAAAAAAAAAAAAAAAAAAAAAAAAAAAAAAAAAAAO
