None
OeOOOOOOOOOOOOOO1OAOGOOAO
OsO2OOOOOOOOOOOAAAAAAAAAO
AAAAAOOOOOOOOOOAOOOOOOOOO
OOOOOOOOOOOOOOOAOOOOOOOOO
PPPPPPPPPPPPPPPAOOOOOOOOO
AAAAAAAAAAAAAAAAOBOOOOOOO
OOOOOOOOOOOOOOOAOOOOOOOOO
OOOOOOOOOOOOOOOAOOOOOOOOO
OOOOOOOOOOOOOOOAOOOOMMMOO
OOOOOOOOOOOOOOOAOOOOOOOOO
OOOOOOOOOOOOO1OAOOOOOOOOO
OOOOOOOOOOOOAAAAOOOOOOOOO
OOOOOOOOOOOOAOOOOOOOOOOOO
OEOOOOOOOOOOAOOOOMMMOOOOO
OSAOOOOOOOOOAOOOOOOOOOOOO
AAAOQOOOOOOOAOOOOOOOOOOOO
AAAOOOOOOOOOAOOOOOOOOOOOO
AAAOOOOOOOOOAOOOOOO2OOOOO
AAAOMOOOOOOrAOOOOAAAAAOOO
AAAOOOOOOOOAAOOOOOOOOOOOO
