None
OOOOOOOOOOOOOOOOOOOO
OOOOOOOOOOOOOOOOOOOO
OOOOOOOOOOOOO1OOOOOO
OOOOOOOOOOOOOOOOOOOO
OOOOOOOOOOOOOOOOOOOO
OOOOOOOOOOOOOOOOOOOO
OOOOOOOOOOOOOOOOOOOO
OOOOOOOOOOOOOOOOOOOO
OOOOOOOOOOOOOOOOOOOO
EOOOOOOOOOOOOOOOOOAA
SOOOOOOOOO1OOOO1OOAA
AAAAAAAAAAAOOOOOOOAA
AAAAAAAAAAAOOOOOOOAA
AAAAAAAAAAAOOOOOOOAA
AAAAAAAAAAAPPPPPPPAA
