None
OOOOOOOOOOOOOOOOOOOO
OOOOOOOOOOOOOOOOOOOO
OOOOOOOOOOOOOOOOOOOO
OOOOOOOOOOOOOOOOOOOO
OOOOOOOOOOOOOOOOOOOO
OOOOOOOOOOOOOOOOOOOO
OOOOOOOOOOOOOOOOOOOO
OOOOOOOOOOOOOOOOOOOO
OOOOOOOOOKOOOOOOOOOO
EOOOOOOOOOOOOOLLLOOe
SOOOOOOOMMMOOOLGLOOs
AAAAAAAOOOOOOOAAAAAA
AAAAAAAOOOOOOOAAAAAA
AAAAAAAOOOOOOOAAAAAA
AAAAAAAPPPPPPPAAAAAA
