None
OOAOOOOOOOOOOOOOOOOO
OOOOOOOOOOOAAAAAOOOO
OOOOOOOOOOOAOTOAOOOO
OOOOOOOOOOOAOOOAOOOO
OOOOOOOOOOOAOOOAOOOO
OOOOOOOOOOOAOOOAOOOO
OOOOOOOOOOrAOOOArOOO
OOOAAAAAAAAAAAAAAAOO
OOOAOOOAOOOOAOOOOAOO
OOOAOOOAOOOOAOOOOAOO
OOOATOOAOOOOAOOOTAOO
EOOAOOOAOOOOAOOOOAOO
SOrAOOOAOTOOAOOOOAOO
AAAAAAAAAAAAAAAAAAOO
AAAAAAAAAAAAAAAAAAOO
