None
OOOOOOOOOOOOOOOOOOOO
OOOOOOOOOOOOOOOOOOOO
OOOOOOOOOOOOOOOOOOOO
OOOOOOOOOOOOOOOOOOOO
OOOOOOOOOOOOOOOOOOOO
OOOOOOOOOOOOOOOOOOOO
OOOOOOOOEOOOOOOOOOOO
OOOOOOOOSOOOOOOOOOOO
OOOOOOOOAAOOOOOOOOOO
OOOOOOOOAAOOOOOOOOOO
OOGGGGGOAAOOOOOOOOOO
AAAAAAAAAAOOOOOOOOOO
AAAAAAAAAAOOOOOOOOOO
AAAAAAAAAAOOOOOOOOOO
AAAAAAAAAAOOOOOOOOOO
