None
OOOOOOOOOOOOOOOOOOOO
OOOOOOOOOOOOOOOOOOOO
OOOOOOOOO1OO2OOOOOOO
OOOOOOOOAAAAAAOOOOOO
OOOOOOOOAAAAAAOOOOOO
AOOOQOOOOOOOOOOOOOOA
AOOOOOOOOOOOOOOQOOOA
OOOOOOOOOOOOOOOO2OeO
OOOOOOOOOOOOOAAAAAsO
OOOOOOOOOOOOOAAAAAAO
OOOOOOOOOOOOOOOOOOOO
EOOOOOOOOOOOOOOOOOOO
SOOO1OOOOOOOOOOOOOOO
AAAAAAAOOOOOOOOOOOOO
AAAAAAAOOOOOOOOOOOOO
