None
OOOOOOOOOOOOOOOOOOOO
OOAOOOOOOOOOOOOOOAOO
OOAOBOOOOOOOOOOOOAOO
OOAOOOOOOOOOOOOBOAOO
OOAOOOOOOOOOOOOOOAOO
OOAOOOOOOEOOOOOOOAOO
1OArOOOOOSOOOOOOrAO2
AAAAOMMOAAAAOMMOAAAA
OOOAOOOOAOOAOOOOAOOO
OOOAPPPPAOOAPPPPAOOO
OOOAAAAAAOOAAAAAAOOO
OOOOOOOOAOOAOOOOOOOO
OOOOOOOOAOOAOOOOOOOO
O'''OOOOAOOAOOOOOOOO
O'e'OOOOAOOAOOOOOOOO
O's'O2OOAOOAOO1OG;GO
AAAAAAAAAAAAAAAAAAAA
