None
OOOOOOOOOOOOOOOOOOOOOOOOO
OOOOOOOOOOOOOOOOOOOOOOOOO
OOOOOOOOOOOOOOOOOOOOOOOOO
OOOOOOOOOOOOOOOOOOOOOOOOO
OOOOOOOOOOOOOOOOOOOOOOOOO
OOOOOOOOOOOOOOOOOOOOOOOOO
OOOOOOOOOOOPPPOOOOOOOOOOO
OOOOOOOOOOPAAAPOOOOOOOOOO
OOOOOOOOOOPAKAPOOOOOOOOOO
OOOOOOOOOOPAOAPOOLLLOOOOO
EOOOOOOOOOOOOOOOOLeLOOOOO
SOOOOOOOOOOOOOOOOLsLOOOOO
AAAAAAAAAOOMMMOOAAAAAAAOO
AAAAAAAAAPPPPPPPAAAAAAAOO
AAAAAAAAAAAAAAAAAAAAAAAOO
