OOOOOOOOOOOOOOOOOOOOOOOOOOO
OOOOOOOOOOOOOOOOOOOOOOOOOOO
OOOOOOOOOOOOOOOOOOOOOOOOOOe
OOOOOOOOOOOOOOOOOOOOOOOOOOs
OOOOOOOOOOOOOAOOOMMMOOOOAAA
EOOOOOOAAOOOAAWWWWWWWWWWAAA
SOOPAAAAAAAAAAWWWWWWWWWWAAA
AAAAAAAAAAAAAAAAAAAAAAAAAAA
AAAAAAAAAAAAAAAAAAAAAAAAAAA