None
OOOYOOOOOOOOOOOOOOOO
OOOAAAOOAAAAAAAAAAOO
OOOAOOOOOOOOAOOOOAOO
OOOAOOOOOOOOAOOOOAOO
OOOATOOOOOOOAOOOOAOO
EOOAOOOOOOOOAOOOOAOO
SOrAOOOOOOOOAOOOOAOO
AAAAAAAAAAAAAAAAAAOO
AAAAAAAAAAAAAAAAAAOO
