OOOOOOOOOOOOOOOOOOOOOOOO'''OOOOOOOOO
OOOOOOOOOOOOOOOOOOOOOOOO'e'OOOOOOOOO
OOOOOOOAAOOOOOOOOOOOOOOO's'OOOOOOOOO
OOOOOOOPPOOOOcOOOOOOOOOAAAAAOOOOOOOO
OOOOOOOOOOOOOAPOOOOOOOOOOOBOOOOOOOOP
OOOOOOOOOOOOOAPOOOOOOOOOOOOOOOOOOOPA
OOOOOOOAAOOOAAPOOOOOMMMOOOOOOOOOOOPA
EOOOOOOAAOOOAAPOQOOOOOOOOOOOOOOOOOPA
SOOOAAAAAAAAAAOKOGOOOOOPPOOOOOOOOOPA
AAAAAAAAAAAAAAAAAAAAAAAAAOOOMMMOOOPA
AAAAAAAAAAAAAAAAAAAAAAAAALLLOOOOOOPA
OOOOOOOOOOOOOOOOOOOOOOOAAL;LOOcOOOOA
OOOOOOOOOOOOOOOOOOOOOOOAAAAAAAAAAAAA